#######################
#     ###########     #
# ###             ### #
# ### ########### ### #
# ###      #      ### #
#     ####   ####     #
# ###      #      ### #
# #     ## # ##     # #
# # #      #      # # #
#      #       #      #
# ###             ### #
# ### ########### ### #
# ###      #      ### #
#     ####   ####     #
# ###      #      ### #
# #     ## # ##     # #
# # #      #      # # #
#      #       #      #
# #     ## # ##     # #
# # #      #      # # #
#      #       #      #
# ###             ### #
# ### ########### ### #
# ###      #      ### #
#     ####   ####     #
#######################