#######################
#       #######       #
# ####   #####   #### #
#      #       #      #
# ## # ######### # ## #
# ## #     #     # ## #
#    ###       ###    #
# #      #####      # #
#   ####       ####   #
# # #     ###     # # #
# # # ########### # # #
# # #      #      # # #
#     #### # ####     #
# ###      #      ### #
#      ###   ###      #
# ## #     #     # ## #
#    ###       ###    #
# #      #####      # #
#   ####       ####   #
# # #    #####    # # #
#     ###########     #
#######################